NO textures/sky/sky.xpm
SO textures/sky/sky.xpm
WE textures/sky/sky.xpm
EA textures/sky/sky.xpm


F 100 ,0, 20





C 80, 10, 100


11111111111111111111
10000100000000010001
10110101111110010101
10100100000010010101
10101111111010010101
10100000000010010101
10111110111110010101
10000010100000010101
11111010101111110101
10000010101000000101
10111110101011111101
10100000101010000001
101011101010101100W1
10000100000100000001
11111111111111111111
